1111111111
10000C0001
1010E00001
11P1000001
1111111111
