1111111111
10000C0001
1000E00001
10PP000001
1111111111
