1111111111
10000C0001
1000E00001
10P0000001
1111110111
