1111111111
10000C0001
10C0000111
10P000EC01
1111111111
