1111111111
10000C001
1000E001
10P0001
111111111
