1111111111
10001C1001
10C0E10001
10P000C001
1111111111
