1111111111
10000C0001
10C0001001
10P001E101
1111111111
