11111111
100CP001
10C000E1
1111111111111111
100CP001
10C000E1
1111111111111111
100CP001
10C000E1
1111111111111111
100CP001
10C000E1
1111111111111111
100CP001
10C000E1
1111111111111111
100CP001
10C000E1
1111111111111111
100CP001
10C000E1
1111111111111111
100CP001
10C000E1
1111111111111111
100CP001
10C000E1
1111111111111111
100CP001
10C000E1
1111111111111111
100CP001
10C000E1
11111111
