1111111111
1P001000C1
11E0C011C1
1111111111
