1111111111111
1C1100C0000C1
1010C11111C01
1P0011E00C001
1111111111111
