1111111111111111111111111111111111
1P1C0000000000C00100C00000000000C1
1010010100100000101001000000C10111
1010010010101010001001000000010111
100010000C00C000000000C000E0000111
1111C000111100110000111000C000C111
111111111111111C01111C0000011100C1
1111111111111111111111111111111111
